C 60, 0, 0

F 170, 86, 86

NO assets/cats.png
SO assets/birds.png
WE assets/woodland.png
EA assets/vagabond.png
SPRITE assets/anim.png

    111
11111A11111
10000000001
1000AAA0001
10000N00001
10000000001
10000000001
10000A00001
1000A0A0001
100A000A001
11111111111
