NO assets/a1.png
SO assets/a1.png
WE assets/a2.png
EA assets/a2.png
DOOR assets/bathdoor.png
SPRITE assets/anim.png

F 159, 173, 196

C 206, 212, 222

11111111111
11A1A1A1A11
11C1C1C1C11
10000000001
10111111111
10000000001
10000N00001
11111111111