C 0, 0, 0

F 0, 0, 0

NO assets/glass.png
SO assets/glass.png
WE assets/glass.png
EA assets/glass.png
SPRITE assets/gnome.png

    111
11111A11111
10000000001
1000AAA0001
10000N00001
10000000001
10000000001
10000A00001
1000A0A0001
100A000A001
11111111111
