C 77, 44, 90

F 170, 86, 86

NO map/tmp.png
SO map/tmp.png
WE map/tmp.png
EA map/tmp.png

11111111111
10000000001
100000000W1
10000000001
10111111101
101     101
10111111101
10000000001
11111111111
