C 60, 0, 0

F 170, 86, 86

NO map/cats.png
SO map/birds.png
WE map/woodland.png
EA map/vagabond.png
DOOR map/door.png
SPRITE map/anim_test.png
    111
11111A11111
10000000001
1000A0A0001
10000N00001
10111111101
101     1O1
101111111C1
10000000001
11111111111
