C 60, 0, 0

F 170, 86, 86

NO map/cats.png
SO map/birds.png
WE map/woodland.png
EA map/vagabond.png
DOOR map/pedro.png

11111111111
10000000001
10000000001
10000000001
10111111101
101     1O1
101111111C1
100000000N1
11111111111
