C 60, 0, 0

F 170, 86, 86

NO map/cats.png
SO map/birds.png
WE map/woodland.png
EA map/vagabond.png
DOOR map/meme.png
SPRITE map/pedro.png

11111111111
10000A00001
10000C00001
10000N00001
10111111101
101     1O1
101111111C1
10000000001
11111111111
