C 77, 44, 90

F 170, 86, 86

NO map/cats.png
SO map/birds.png
WE map/woodland.png
EA map/vagabond.png

11111111111
1N000000001
10000000001
10111111101
101     101
10111111101
10000000001
11111111111
