C 121, 212, 212

F 64, 46, 26

NO assets/cats.png
SO assets/birds.png
WE assets/woodland.png
EA assets/vagabond.png

    111
11111011111
10000000001
10000000001
10000N00001
10111111101
101     101
10111111101
10000000001
11111111111
