NO ./somewere
SO ./somewere
WE ./somewere
EA ./somewere

C 77, 44, 90
F 170, 86, 86


1111111111111
1111100100001
1111001101001 11111
1110011111011 10001
1100N00100101 11111
1000000100001
1111100111111
1111100111111
1111111111111
