NO ./somewere
SO ./somewere
WE ./somewere
EA ./somewere

C ./somewere
F ./somewere
F ./somewere
 ./somewere

110111
100101111111111
1010000000000N1
110001111111111
111111
F ./somewere