C 60, 0, 0

F 170, 86, 86

SO map/pedro.png
NO map/birds.png
WE map/woodland.png
EA map/vagabond.png

11111111111
10000000001
10000000001
10000000001
10111111101111111111111111111111111
101     101100000000000000000000001
1011111110000000000000000000000000111111111111111111111111111111111111110
10000000000000000000000000000000000000000000000000000000000000000000000W1
1000000000110000000000000000000000111111111111111111111111111111111111111
11111111111111111111111111111111111
