C 60, 0, 0

F 170, 86, 86

NO assets/a1.png
SO assets/a2.png
WE assets/a1.png
EA assets/a2.png
    
1111
1101
1N11
1111